# # # # # # # # #
# . . . # . . S #
# . . . # . . . #
# . . . . . . . #
# . . . # # . # #
# . # # # . . . #
# . . . # . . . #
# G . . . . . . #
# # # # # # # # #
