# # # # # # # # #
# . . . # . . . #
# . . . # . . . #
# . . . . . . . #
# . . S # # . # #
# . # # # G . . #
# . . . # . . . #
# . . . . . . . #
# # # # # # # # #
