# # # # # # # # #
# S . . # . . . #
# . . . # . . . #
# . . . . . . . #
# . . . # # . # #
# . # # # . . . #
# . . . # . . . #
# . . . . . . G #
# # # # # # # # #
