# # # # # # # # #
# G . . # . . . #
# . . . # . . . #
# . . . . . . . #
# . . . # # . # #
# . # # # . . . #
# . . . # . . . #
# . . . . . . S #
# # # # # # # # #
