# # # # # # # # #
# . . S # . . . #
# . . . # . . . #
# . . . . . . . #
# . . . # # . # #
# . # # # G . . #
# . . . # . . . #
# . . . . . . . #
# # # # # # # # #
