# # # # # # # # #
# . . . # . . . #
# . . . # . . . #
# G . . . . . . #
# . . . # # . # #
# . # # # . . . #
# . . . # . S . #
# . . . . . . . #
# # # # # # # # #
