# # # # # # # # #
# . . . # . . . #
# . . . # . . . #
# . . . . . . . #
# . . . # # S # #
# G # # # . . . #
# . . . # . . . #
# . . . . . . . #
# # # # # # # # #
